Microsoft Windows [Version 10.0.19045.6093]
(c) Microsoft Corporation. All rights reserved.

C:\Users\Vaishnavi Borase>docker --version
Docker version 28.3.2, build 578ccf6

C:\Users\Vaishnavi Borase>docker run hello-world

Hello from Docker!
This message shows that your installation appears to be working correctly.

To generate this message, Docker took the following steps:
 1. The Docker client contacted the Docker daemon.
 2. The Docker daemon pulled the "hello-world" image from the Docker Hub.
    (amd64)
 3. The Docker daemon created a new container from that image which runs the
    executable that produces the output you are currently reading.
 4. The Docker daemon streamed that output to the Docker client, which sent it
    to your terminal.

To try something more ambitious, you can run an Ubuntu container with:
 $ docker run -it ubuntu bash

Share images, automate workflows, and more with a free Docker ID:
 https://hub.docker.com/

For more examples and ideas, visit:
 https://docs.docker.com/get-started/


C:\Users\Vaishnavi Borase>docker run -it ubuntu bash
Unable to find image 'ubuntu:latest' locally
latest: Pulling from library/ubuntu
32f112e3802c: Pull complete
Digest: sha256:a08e551cb33850e4740772b38217fc1796a66da2506d312abe51acda354ff061
Status: Downloaded newer image for ubuntu:latest
root@31276074b83c:/# ls
bin  boot  dev  etc  home  lib  lib64  media  mnt  opt  proc  root  run  sbin  srv  sys  tmp  usr  var
root@31276074b83c:/# pwd
/
root@31276074b83c:/# apt update
Get:1 http://archive.ubuntu.com/ubuntu noble InRelease [256 kB]
Get:2 http://security.ubuntu.com/ubuntu noble-security InRelease [126 kB]
Get:3 http://archive.ubuntu.com/ubuntu noble-updates InRelease [126 kB]
Get:4 http://security.ubuntu.com/ubuntu noble-security/restricted amd64 Packages [1870 kB]
Get:5 http://archive.ubuntu.com/ubuntu noble-backports InRelease [126 kB]
Get:6 http://archive.ubuntu.com/ubuntu noble/multiverse amd64 Packages [331 kB]
Get:7 http://archive.ubuntu.com/ubuntu noble/main amd64 Packages [1808 kB]
Get:8 http://archive.ubuntu.com/ubuntu noble/universe amd64 Packages [19.3 MB]
Get:9 http://security.ubuntu.com/ubuntu noble-security/universe amd64 Packages [1131 kB]
Get:10 http://security.ubuntu.com/ubuntu noble-security/main amd64 Packages [1285 kB]
Get:11 http://security.ubuntu.com/ubuntu noble-security/multiverse amd64 Packages [23.0 kB]
Get:12 http://archive.ubuntu.com/ubuntu noble/restricted amd64 Packages [117 kB]
Get:13 http://archive.ubuntu.com/ubuntu noble-updates/restricted amd64 Packages [1985 kB]
Get:14 http://archive.ubuntu.com/ubuntu noble-updates/multiverse amd64 Packages [45.2 kB]
Get:15 http://archive.ubuntu.com/ubuntu noble-updates/main amd64 Packages [1621 kB]
Get:16 http://archive.ubuntu.com/ubuntu noble-updates/universe amd64 Packages [1443 kB]
Get:17 http://archive.ubuntu.com/ubuntu noble-backports/universe amd64 Packages [33.0 kB]
Get:18 http://archive.ubuntu.com/ubuntu noble-backports/main amd64 Packages [48.8 kB]
Fetched 31.7 MB in 9s (3704 kB/s)
Reading package lists... Done
Building dependency tree... Done
Reading state information... Done
2 packages can be upgraded. Run 'apt list --upgradable' to see them.
root@31276074b83c:/# apt install nano
Reading package lists... Done
Building dependency tree... Done
Reading state information... Done
Suggested packages:
  hunspell
The following NEW packages will be installed:
  nano
0 upgraded, 1 newly installed, 0 to remove and 2 not upgraded.
Need to get 282 kB of archives.
After this operation, 856 kB of additional disk space will be used.
Get:1 http://archive.ubuntu.com/ubuntu noble-updates/main amd64 nano amd64 7.2-2ubuntu0.1 [282 kB]
Fetched 282 kB in 3s (85.7 kB/s)
debconf: delaying package configuration, since apt-utils is not installed
Selecting previously unselected package nano.
(Reading database ... 4381 files and directories currently installed.)
Preparing to unpack .../nano_7.2-2ubuntu0.1_amd64.deb ...
Unpacking nano (7.2-2ubuntu0.1) ...
Setting up nano (7.2-2ubuntu0.1) ...
update-alternatives: using /bin/nano to provide /usr/bin/editor (editor) in auto mode
update-alternatives: warning: skip creation of /usr/share/man/man1/editor.1.gz because associated file /usr/share/man/man1/nano.1.gz (of link group editor) doesn't exist
update-alternatives: using /bin/nano to provide /usr/bin/pico (pico) in auto mode
update-alternatives: warning: skip creation of /usr/share/man/man1/pico.1.gz because associated file /usr/share/man/man1/nano.1.gz (of link group pico) doesn't exist
root@31276074b83c:/# exit
exit

C:\Users\Vaishnavi Borase>docker ps
CONTAINER ID   IMAGE     COMMAND   CREATED   STATUS    PORTS     NAMES

C:\Users\Vaishnavi Borase>docker ps -a
CONTAINER ID   IMAGE                                 COMMAND                  CREATED              STATUS                      PORTS                                                                                                                                  NAMES
31276074b83c   ubuntu                                "bash"                   About a minute ago   Exited (0) 24 seconds ago                                                                                                                                          intelligent_brahmagupta
0044b646b75d   hello-world                           "/hello"                 2 minutes ago        Exited (0) 2 minutes ago                                                                                                                                           jovial_diffie
b9c764f91253   hello-world                           "/hello"                 7 minutes ago        Exited (0) 7 minutes ago                                                                                                                                           interesting_cray
12b24010a64f   gcr.io/k8s-minikube/kicbase:v0.0.47   "/usr/local/bin/entr…"   9 days ago           Exited (255) 2 days ago     127.0.0.1:32768->22/tcp, 127.0.0.1:32769->2376/tcp, 127.0.0.1:32770->5000/tcp, 127.0.0.1:32771->8443/tcp, 127.0.0.1:32772->32443/tcp   minikube

C:\Users\Vaishnavi Borase>docker rm 31276074b83c 0044b646b75d b9c764f91253
31276074b83c
0044b646b75d
b9c764f91253

C:\Users\Vaishnavi Borase>docker container prune
WARNING! This will remove all stopped containers.
Are you sure you want to continue? [y/N] docker container prune

C:\Users\Vaishnavi Borase>docker run -it --rm ubuntu bash
root@4d2ce87fe17f:/# docker images
bash: docker: command not found
root@4d2ce87fe17f:/# ls
bin  boot  dev  etc  home  lib  lib64  media  mnt  opt  proc  root  run  sbin  srv  sys  tmp  usr  var
root@4d2ce87fe17f:/# exit
exit

C:\Users\Vaishnavi Borase>docker images
REPOSITORY                                        TAG       IMAGE ID       CREATED        SIZE
ubuntu                                            latest    a08e551cb338   8 days ago     117MB
vaishacrregistryvaishnavi01.azurecr.io/vaishapp   v1        2bd055256677   5 weeks ago    189MB
gcr.io/k8s-minikube/kicbase                       v0.0.47   8311be96a0a8   2 months ago   1.86GB
gcr.io/k8s-minikube/kicbase                       <none>    6ed579c9292b   2 months ago   1.86GB
hello-world                                       latest    ec153840d1e6   6 months ago   20.4kB

C:\Users\Vaishnavi Borase>docker ps
CONTAINER ID   IMAGE     COMMAND   CREATED   STATUS    PORTS     NAMES

C:\Users\Vaishnavi Borase>vaishacrregistryvaishnavi01.azurecr.io/vaishapp:v1
'vaishacrregistryvaishnavi01.azurecr.io' is not recognized as an internal or external command,
operable program or batch file.

[+] Building 0.3s (1/1) FINISHED                                                                    docker:desktop-linux
 => [internal] load build definition from Dockerfile                                                                0.1st
 => => transferring dockerfile: 2B                                                                                  0.0s
ERROR: failed to build: failed to solve: failed to read dockerfile: open Dockerfile: no such file or directory
C:\Users\Vaishnavi Borase>docker build -t vaishacrregistryvaishnavi01.azurecr.io/vaishapp:v1 .
C:\Users\Vaishnavi Borase>docker rmi a08e551cb338
Untagged: ubuntu:latest
Deleted: sha256:a08e551cb33850e4740772b38217fc1796a66da2506d312abe51acda354ff061

C:\Users\Vaishnavi Borase>docker images
REPOSITORY                                        TAG       IMAGE ID       CREATED        SIZE
vaishacrregistryvaishnavi01.azurecr.io/vaishapp   v1        2bd055256677   5 weeks ago    189MB
gcr.io/k8s-minikube/kicbase                       v0.0.47   8311be96a0a8   2 months ago   1.86GB
gcr.io/k8s-minikube/kicbase                       <none>    6ed579c9292b   2 months ago   1.86GB
hello-world                                       latest    ec153840d1e6   6 months ago   20.4kB

C:\Users\Vaishnavi Borase>
